+++++++++++++++++++++++++++++++++
+    -------           ---    +
+ x       --- +   y  +    ++    +
+    +++           +            +
+ ----    +++      +            +
+    - -+ -   +  ----    +++    +
+    -  -   +          +   ---- +
+    +++      ----   +          +
+        y              - -     +
+ ----      ---+++    -- y      +
+  ++ --- -       +++           +
+        y     --   ----        +
+ ---  +++         ++++-        +
+                ----   ++      +
+ ---+++  ----   --       y ++  +
+   ----      +++           ++  +
+++++++++++++++++++++++++++++++++